11111111111111111111111111111111111111111111111111111111111111111111111111111111111111111111111111111111111111111111111111111111111111111
1E0000000000000C00000C000000000000100000000000000C00000C000000000000100000000000000C00000C000000000000000000000000000C00000C0000000000001
10100101001000001010010000000101000000010100100000101001000000010100000001010010000010100100000001010000000101001000001010010000000101001
10000100101010100010010000000101000000010010101010001001000000010100000001001010101000100100000001010001100100101010100010010000000101001
1P0000000C00C0000000000000000000C0101000000C00C0000000000000000000C0101000000C00C0000000000000000000C0101000000C00C0000000000000000000C01
11111111111111111111111111111111111111111111111111111111111111111111111111111111111111111111111111111111111111111111111111111111111111111
