11111111111111
11111100P01111
11111EC1000111
11111111111111
